1111111111111111111111
0000000000000000000001
0000000000000000000001
0000000000000000000001
0000000000000000000001
0000000000000000000001
0000000000000000000001
0000000000000000000001
0111111111111111111111
1000000000000000000000
1000000000000000000000
1000000000000000000000
1111111111111111111111